aptitude-robot - Automate package choice management
assword - Simple and secure password management and retrieval system.
bittwist - libpcap based Ethernet packet generator
corekeeper - enable core files and report crashes to the sysadmin
cssmin - YUI CSS compression algorithm in Python
debian-lan-config - FAI config space for the Debian-LAN system
editorconfig - coding style indenter for all editors - commadline tools
ext4magic - recover deleted files from ext3 or ext4 partitions
fatrace - report system wide file access events
gitolite3 - SSH-based gatekeeper for git repositories (version 3)
ioapps - IO profiler and IO traces replayer
isenkram - Suggest packages to install when inserting new hardware
jq - lightweight and flexible command-line JSON processor
live-images - live-build configurations (metapackage)
nat-traverse - NAT gateway traversal utility
nicstat - print network traffic statistics
nocache - bypass/minimize file system caching for a program
pg-activity - Realtime PostgreSQL database server monitoring tool
pgbadger - Fast PostgreSQL log analysis report
pgreplay - replay PostgreSQL log files
premake4 - cross-platform build script generator
sanewall - easy to use but powerful iptables stateful firewall (program)
seekwatcher - utility to visualize block I/O patterns
stdsyslog - log a program's output to the system log
wxhexeditor - hexadecimal editor for massive files
ecryptfs-utils - ecryptfs cryptographic filesystem (utilities)
clang-format-3.4 - Tool to format C/C++/Obj-C code
monkeysign - OpenPGP key signing and exchange for humans
spl-dkms - Solaris Porting Layer kernel modules for Linux
sssd-ipa - System Security Services Daemon -- IPA back end
autorevision - extracts revision metadata from your VCS repository
clog - colorizing log tail utility
clsync - live sync tool based on inotify, written in GNU C
codesearch - regular expression search over large bodies of source code
core-network - intuitive network emulator that interacts with real nets (metapackage)
criu - checkpoint and restore in userspace
dgit - git interoperability with the Debian archive
droopy - mini web server to let others upload files to your computer
enhanceio-dkms - dynamic block device cache for Linux (DKMS version)
ganeti - Cluster-based virtualization management software
git-notifier - git commit email notification script
git-remote-gcrypt - encrypted git repositories
grokmirror - framework to smartly mirror git repositories
gromit-mpx - GTK based tool to make annotations on screen with multiple pointers
how-can-i-help - show opportunities for contributing to Debian
ifupdown-multi - multiple default gateway support for ifupdown
lmdb-utils - Lightning Memory-Mapped Database Utilities
lnav - ncurses-based log file viewer
macfanctld - fan control daemon for Apple MacBook / MacBook Pro computers
mdpress - creation of Impress.js slideshows with Markdown
mpv - Free and open-source general-purpose video player.
mussort - simple tool that sorts a music collection
nbdkit - toolkit for creating NBD servers
needrestart - check which daemons need to be restarted after library upgrades
olla - hack to avoid typing out full domains
openstack-debian-images - script to build a Debian image for OpenStack
pepperflashplugin-nonfree - Pepper Flash Player - browser plugin
photofloat - Web 2.0 Photo Gallery Done Right via Static JSON & Dynamic Javascript
proot - emulate chroot, bind mount and binfmt_misc for non-root users
pry - powerfull irb alternative and runtime developer console
shellex - shell-based launcher
sosreport - Set of tools to gather troubleshooting data from a system
ssh-agent-filter - filtering proxy for ssh-agent
stegsnow - steganography using ASCII files
vmdebootstrap - Bootstrap Debian into a (virtual machine) disk image
vramsteg - provide shell scripts with a full-featured progress indicator
zbackup - Versatile deduplicating backup tool
nxlog-ce - Modular, multi-threaded, high-performance log management solution
pitivi - non-linear audio/video editor using GStreamer
krb5-otp - OTP plugin for MIT Kerberos
mk-configure - lightweight replacement for GNU autotools
attic - deduplicating backup program
diskscan - scan HDD/SSD for bad or near failure sectors
awscli - Universal Command Line Environment for AWS
bugs-everywhere - distributed bug tracking system using VCS storage
codespell - find and fix common misspellings in text files
converseen - batch image converter and resizer
docker.io - Linux container runtime
fdroidserver - F-Droid build server and repository tools for Android
fonts-isabella - Isabella free TrueType font
fssync - File system synchronization tool (1-way, over SSH)
gtimelog - time logging application
httraqt - program for downloading of internet sites
kernelshark - Utilities for graphically analyzing function tracing in the kernel
keyringer - Distributed secret management using GnuPG and Git
logster - Generate metrics from logfiles for Graphite and Ganglia
metamonger - Save, diff, and restore filesystem metadata
netmate - netdude clone that shows pcap dump lines in network header style
slowhttptest - application layer Denial of Service attacks simulation tool
snapper - Linux filesystem snapshot management tool
spiped - create secure pipes between socket addresses
taskwarrior - feature-rich console based todo list manager
ui-auto - Autotools library and development tools
vim-youcompleteme - fast, as-you-type, fuzzy-search code completion engine for Vim
whiteboard - simple collaborative text editor for the web
zmap - network scanner for researchers
jscommunicator-web-phone - Basic SIP video-phone web page using WebRTC
entr - Run arbitrary commands when files change
netscript-ipfilter - Linux 2.6/3.x iptables management system.
newpid - run a command in a new PID namespace
trinity - system call fuzz tester
pgtop - PostgreSQL performance monitoring tool akin to top
health-check - process monitoring tool
udevil - Alternative storage media interface
ngrok-client - secure introspectable tunnels to localhost - client part
simple-tpm-pk11 - simple library for using the TPM chip to secure SSH keys
speedtest-cli - Command line interface for testing internet bandwidth using speedtest.net
nghttp2 - nghttp HTTP 2.0 servers
slt - TLS reverse-proxy with SNI multiplexing (TLS virtual hosts)
git-merge-changelog - git merge driver for GNU ChangeLog files
qjoypad - Program for mapping gamepad/joystick events to mouse/keyboard event
salt-cloud - public cloud VM management system
arriero - Simplifies management of several Debian packages
cgroupfs-mount - Light-weight package to set up cgroupfs mounts
forkstat - process fork/exec/exit monitoring tool
light-locker - simple screen locker for lightDM display manager
syslog-ng-mod-elasticsearch - Enhanced system logging daemon (ElasticSearch plugin)
designate - OpenStack DNS as a Service - metapackage
fotoxx - easy-to-use digital photo editor
gatling - high performance web server and file server
sysdig - system-level exploration and troubleshooting tool
propellor - property-based host configuration management in haskell
netfilter-persistent - boot-time loader for netfilter configuration
whatmaps - Find processes mapping shared objects
key2odp - Keynote to OpenDocument converter
ndiff - The Network Mapper - result compare utiltiy
rsyslog-elasticsearch - Elasticsearch output plugin for rsyslog
tgt - Linux SCSI target user-space daemon and tools
livestreamer - CLI that pipes video streams to video players
knot - authoritative domain name server
airspy - Tiny and efficient software defined radio receiver
ceph-dkms - Ceph FS and RBD Linux kernel drivers (DKMS version)
direnv - Utility to set directory specific environment variables
dms - bind9 DNS Management System, master server meta-package
libnss-wrapper - NSS wrapper library
python-bash8 - bash script style guide checker - Python 2.x
snetz - simple live network bandwidth monitoring tool
stress-ng - tool to load and stress a computer
munin-node-c - C rewrite of Munin node
dhcpy6d - MAC address aware DHCPv6 server written in Python
hello-traditional - example package not using any helper package
idlestat - measure CPU time in idle and operating states
shellcheck - lint tool for shell scripts
syslog-nagios-bridge - Syslog to Nagios integration
heartbleeder - test servers for OpenSSL CVE-2014-0160 aka Heartbleed
screenfetch - Bash Screenshot Information Tool
powerline - ultimate statusline/prompt utility
meson - high-productivity build system
postgresql-9.3-reorg - reorganize tables in PostgreSQL databases without any locks
python-rarfile - RAR archive reader module for Python (python 2)
s3curl - Easily interact with AWS S3 HTTP services
tcpflow-nox - TCP flow recorder - version without X11 dependencies
guncat - Catenates files while decrypting PGP-encrypted sections
abduco - terminal session manager
apachedex - Compute APDEX from Apache-style logs
icinga2 - host and network monitoring system
ntopng - High-Speed Web-based Traffic Analysis and Flow Collection Tool
pcredz - Extracts authentication credentials from network captures
git-remote-hg - bidirectional bridge between Git and Mercurial
libuid-wrapper - UID wrapper library
xxdiff - graphical file/directory comparison and merge tool
cgmanager - Central cgroup manager daemon
git-reintegrate - Git extension to manage integration branches
lilyterm - Light and eazy-to-use terminal emulator for X
tiptop - performance monitoring tool for Linux
flowgrind - Distributed network performance measurement tool
subliminal - Command-line tool to search and download subtitles
yowsup-cli - command line tool that acts as WhatsApp client
gstreamer1.0-vaapi - VA-API plugins for GStreamer
lua-elektra - elektra configuration store, Lua bindings
ssh-cron - cron daemon allowing ssh keys with passphrases to be used
ghp-import - Easily import docs to your gh-pages branch
monitoring-plugins-standard - Plugins for nagios compatible monitoring systems (standard)
tcpcryptd - Opportunistically encrypt network transport
shc - Generic shell script compiler
datamash - statistics tool for command-line interface
freeipmi-ipmiseld - GNU IPMI - IPMI node detection tool
fireqos - easy to use but powerful traffic shaping tool (program)
air-quality-sensor - user space driver for AppliedSensor's Indoor Air Monitor
android-permissions - create gids that represent Android permissions
apt-transport-s3 - APT transport for privately held AWS S3 repositories
aptly - Swiss army knife for Debian repository management
auto6to4 - Enable IPv6 via IPv4 protocol 41 tunnel
bareos - Backup Archiving Recovery Open Sourced - metapackage
bcache-tools - bcache userspace tools
bootstrap-vz - Software for creating Debian images for use in public or private clouds
capstats - command-line tool for collecting network interface statistics
cleo - Play back shell commands for live demonstrations
cputool - Utility which manages CPU usage and system load
debbindiff - highlight differences between two builds of Debian packages
debdry - Semi-assisted automatic Debian packaging
dtc-core - web control panel for admin and accounting hosting services (fewer depends)
elasticsearch - Open Source, Distributed, RESTful Search Engine
elementary-theme - Official elementary GTK+ theme
enhanceio - dynamic block device cache for Linux (user space utility)
fig - Punctual, lightweight development environments using Docker
fireqos - easy to use but powerful traffic shaping tool (program)
freeipa-server - FreeIPA centralized identity framework -- server
git-buildpackage-rpm - Suite to help with RPM packages in Git repositories
gitinspector - statistical analysis tool for git repositories
goldeneye - HTTP DoS test tool
gpaste - Clipboard management system for GNOME
haproxyctl - Utility to manage HAProxy
i3blocks - highly flexible status line for the i3 window manager
iperf3 - Internet Protocol bandwidth measuring tool
jarisplayer - flash video and audio player for embedding into a web page
karlyriceditor - Karaoke lyrics editor
lastpass-cli - command line interface to LastPass.com
mwc - Powerful website-tracking tool
mysecureshell - SFTP Server with ACL
neopi - web shell code detection
nfct - Tool to interact with the connection tracking system
nield - generate logs related to network interfaces
nutcracker - Fast, light-weight proxy for memcached and Redis
obsession - Session management helpers for lightweight desktop environments
olla - hack to avoid typing out full domains
pdf2htmlex - Converts PDF to HTML while retaining most formatting
perf-tools-unstable - DTrace-like tools for Linux
phabricator - Software engineering platform
phototonic - image viewer and organizer
pidcat - Colored adb logcat that shows entries for specific apps
pki-ca - Certificate System - Certificate Authority
plank - Elegant, simple, clean dock
plowshare4 - Download and upload files from file sharing websites
qmenu - Tool to create simple menus for terminal interfaces
qtop - windowed version of the console top command
rr - application execution recorder, player and debugger
rsbackup - rsync-based backup utility
shinken - Flexible monitoring tool - Meta-package
usbrelay - USB HID relay driver
xss-lock - invoke external screen lock in response to XScreenSaver events
dbab - dnsmasq-based ad-blocking using pixelserv
sysdig - system-level exploration and troubleshooting tool
mina - deployer and server automation tool
debian-installer-8-netboot-amd64 - Debian-installer network boot images for amd64
git-big-picture - Visualization tool for Git repositories
bro - passive network traffic analyzer
fnotifystat - file activity monitoring tool
sluice - rate limiting data piping tool
homesick - keep your dotfiles (configs) in git
presentty - Console-based presentation software
tlp - Save battery power on laptops
dnscrypt-proxy - Tool for securing communications between a client and a DNS resolver
deheader - Find and remove unnecessary includes in C or C++ source files
ksmtuned - enables and tunes Kernel Samepage Merging
live-image-rescue - Live System Image Components (rescue)
ldap-git-backup - Back up LDAP database in an Git repository
blkreplay - block device testing and benchmarking toolkit
btrbk - backup tool for btrfs volumes
cruft-ng - program that finds any cruft built up on your system
dm-writeboost-dkms - log-structured caching for Linux
doublecmd-gtk - twin-panel (commander-style) file manager (GTK2)
edid-decode - Decodes to text the binary EDID information from monitors
physlock - lightweight Linux console locking tool
prometheus - Monitoring system and time series database
sddm - modern display manager for X11
gocode - Go autocompletion daemon
ycmd - code-completion & comprehension server
gobby - infinote-based collaborative text editor
boomaga - virtual printer for viewing a document before printing
ffdiaporama - Movie creator from photos and video clips
tmate - terminal multiplexer with instant terminal sharing
plantuml - text-to-UML converter
signify-openbsd - Lightweight cryptographic signing and verifying tool
bandit - Security oriented static analyzer for python code
hhvm - HipHop Virtual Machine, a JIT replacement for PHP - main runtime
info-beamer - interactive multimedia presentation framework
tarantool-lts - In-memory database with Lua application server
treesheets - Data organizer that covers spreadsheets, mind mappers, and small databases
xserver-xspice - Xspice X server
paexec - execute tasks in parallel
debootstick - Turn a chroot environment into a bootable image
glueviz - Linked data visualization
linssid - graphical wireless scanner
reboot-notifier - daily reboot notification mailer
sigil - multi-platform ebook editor
wrk - HTTP benchmarking tool
cdist - Usable Configuration Management System
ipmiutil - IPMI management utilities
xia - Convert svg to html5 interactive pictures
apacheds - Apache Directory Server
thefuck - spelling corrector of console commands
jeepyb - tools for managing gerrit projects and external sources
darkradiant - Level design toolchain for DOOM3 and The Dark Mod
git-crypt - Transparent file encryption in git
caffeine - prevent the desktop becoming idle in full-screen mode
diffoscope - in-depth comparison of files, archives, and directories
dspdfviewer - Dual-Screen PDF Viewer for LaTeX-beamer
power-calibrate - processor power calibration tool
axel - light command line download accelerator
cedar-backup3 - local and remote backups to CD/DVD media or Amazon S3 storage
check-all-the-things - check all of the things!
gbutils - utilities for command line econometrics
influxdb - Scalable datastore for metrics, events, and real-time analytics
nuxwdog - Watchdog server -- daemon
sshcommand - turn SSH into a thin client specifically for your command
toxiproxy - proxy to simulate network and system conditions
rerun - tool to launch commands and restart them on filesystem changes
xwrited - display write and wall messages as desktop notifications
fonts-babelstone-han - BabelStone Fonts for Han
virtualbox-ext-pack - support for USB 2.0 devices, VirtualBox RDP and PXE boot for Intel cards
duc - high-performance disk usage analyzer
tlsh-tools - compare similar files using fuzzy hashing
unison2.40.102 - file-synchronization tool for Unix and Windows
diaspora - distributed social networking service
debocker - docker-powered package builder for Debian
ori - peer-to-peer distributed file system
lua-any - helper script for shebang lines in Lua scripts
backintime-qt4 - simple backup/snapshot system (graphical interface)
systemd-container - systemd container/nspawn tools
systemd-journal-remote - tools for sending and receiving remote journal logs
cpustat - periodic cpu utilization statistics
numad - User-level daemon that monitors NUMA topology and usage
progress - Coreutils Progress Viewer (formerly known as 'cv')
likwid - toolsuite for performance oriented programmers
actiona - emulate human activity through a powerful GUI and JavaScript
lua-check - static analyzer and a linter for the Lua language
yadifa - Internet Domain Name Server
gb - the project based build tool for Go
jenkins-debian-glue - Jenkins Debian glue scripts
rawdns - raw DNS interface to the Docker API
prospector - comprehensive static Python code analyzer
golint - Linter for Go source code
linuxbrew-wrapper - Missing Package Manager For Linux
numatop - NUMA runtime observation tool
vulture - scans for unused ("dead") code in a Python program
ansiweather - Weather in your terminal, with ANSI colors and Unicode symbols
amber - Elegant HTML templating engine for Go, inspired from HAML and Jade (CLI tool)
reposurgeon - Tool for editing version-control repository history
rows - common, beautiful interface to tabular data, no matter the format
minica - super micro binary to issue new CAs
ratt - Rebuild All The Things!
restricted-ssh-commands - Restrict SSH users to a predefined set of commands
debomatic - automatic build machine for Debian source packages
plotnetcfg - local networking configuration diagram plotter
pond - forward secure, asynchronous messaging for the discerning
netstress - utility designed to stress and benchmark network activity
wordgrinder-ncurses - simple word processor for writing first drafts (terminal version)
testssl.sh - Command line tool to check TLS/SSL ciphers, protocols and cryptographic flaws
yadm - Yet Another Dotfiles Manager
go-mtpfs - Mount MTP devices over FUSE
hitch - scalable TLS proxy
ricochet-im - anonymous metadata-resistant instant messaging
yank - interactively select and yank terminal output to stdout or xsel
fonts-octicons - GitHub's icons font
pompem - automate the search for exploits in various databases
qlipper - Lightweight and cross-platform clipboard history applet
qterminal - QT-based multitab terminal emulator
denyhosts - Utility to help sys admins thwart SSH crackers
lximage-qt - Image viewer for LXQt
fastd - Fast and Secure Tunneling Daemon
forensics-colorize - show differences between files using color graphics
speedpad - ncurses tool to test, train, and increase typing speed
docker-registry - Docker toolset to pack, ship, store, and deliver content
serf - Service orchestration and management tool
ktap - lightweight script-based dynamic tracing tool for Linux
zgen - Lightweight plugin manager for ZSH inspired by Antigen
notary - a tool for running and interacting with trusted collections
fleet - distributed init system using systemd and etcd
screengrab - Crossplatform tool for getting screenshots
systemd-docker - wrapper for "docker run" to handle systemd quirks
conman - serial console management program
s3fs - FUSE-based file system backed by Amazon S3
cadvisor - analyze resource usage and performance characteristics of running containers
kore - Fast SPDY capable web server for web development in C
borgbackup - deduplicating and compressing backup program
diffoscope - in-depth comparison of files, archives, and directories
clitest - performs automatic testing in command lines
intel-cmt-cat - Intel cache monitoring and allocation technology config tool
sx - Scalable public and private cloud storage
miller - name-indexed data processing tool
pseudo - advanced tool for simulating superuser privileges
mycli - CLI for MySQL/MariaDB
s-nail - feature-rich BSD mail(1)
tuptime - report historical system running time.
pgcli - CLI for Postgres
s3backer - Amazon AWS S3-backed virtual hard disk device
tj3 - project management software, aka TaskJuggler
hovercraft - generator for impress.js presentations from reStructuredText
caffeine - prevent the desktop becoming idle in full-screen mode
elki - Data mining algorithm development framework
bumpversion - Version-bump your software with a single command
tmuxinator - Create and manage tmux sessions easily
ocserv - OpenConnect VPN server compatible with Cisco AnyConnect VPN
tryton-server - Tryton Application Platform (Server)
syslog-summary - summarize the contents of a syslog log file
buzztrax - Modular music composer
letsencrypt - Let's Encrypt main client
pypi2deb - PyPI to Debian converter
webcamoid - full featured webcam capture application
apt-show-source - Shows source-package information
taskd - Synchronisation server for taskwarrior
taskwarrior - feature-rich console based todo list manager
cryptol - domain-specific language of cryptography
postgresql-9.4-mimeo - specialized, per-table replication between PostgreSQL instances
tails-installer - Installer for the Tails live operating system
dex - generate and execute Application type .desktop files
iprange - optimizing ipsets for iptables
jailer - Builds and maintains chrooted environments
udiskie - automounter for removable media for Python
corebird - Native Gtk+ Twitter client for the Linux desktop
linux-grsec-base - Linux image base package, grsec featureset
abi-tracker - visualize ABI changes of a C/C++ library
disque - In-memory, distributed message broker
btfs - access torrent files as a filesystem
knockpy - Python tool designed to enumerate subdomains on a target domain
pagemon - interactive memory/page monitoring tool
hugo - Fast and flexible Static Site Generator written in Go
nomacs - image viewer with capability of syncing multiple instances
dhcpstarv - DHCP starvation utility
ctop - Command line / text based Linux Containers monitoring tool
ioprocess - Slave process to perform risky IO
freelan - Peer-to-peer virtual private network daemon
mdp - command-line based Markdown presentation tool
klaus - simple easy-to-set-up Git web viewer
shairport-sync - AirPlay audio player
complexity - tool for analyzing the complexity of C program functions
slurmd - SLURM compute node daemon
lios - Linux intelligent OCR solution
mysql-sandbox - Install and set up one or more MySQL server instances easily
ruby-reek - Code smell detector for Ruby
fgallery - static HTML+JavaScript photo album generator
nordlicht - create colorful video barcodes
asciiart - command line tool to turn images into ASCII art
zstd - fast lossless compression algorithm -- CLI tool
todotxt-cli - simple and extensible shell script for managing your todo.txt
astute - Deployment Orchestrator of Puppet via MCollective
circus - process & socket manager. It can be used to monitor and control
erlang-luerl - implementation of Lua in Erlang
fuel-nailgun-agent - collects a server’s hardware information and submits it
libpam-ssh-agent-auth - PAM Authentication via forwarded ssh-agent
nitroshare - Cross-platform network file transfer application
wiredtiger - high performance, scalable, NoSQL, extensible platform for data management
icingaweb2 - simple and responsive web interface for Icinga
img2pdf - Lossless conversion of raster images to PDF
kea-dhcp4-server - ISC KEA IPv4 DHCP server
maybe - control filesystem modifications before they occur
opensips - very fast and configurable SIP server
pgcharts - turn your PostgreSQL queries into charts
wimtools - Tools for manipulating Windows Imaging files
eviacam - webcam based mouse emulator
fim - a scriptable frame buffer and ascii art image viewer
dnsdist - DNS loadbalancer
grafana - feature rich metrics dashboard and graph editor
sen - Terminal user interface for docker engine
xkcdpass - secure passphrase generator inspired by XKCD 936
androguard - full Python tool to play with Android files
gplaycli - Google Play downloader command line interface
phantomjs - minimalistic headless WebKit-based with JavaScript API
topmenu-gtk2 - Topmenu GTK+ (GTK2 module)
